@@@@@@@@@@@@@@@@@@@@@@@@@@@@@@@@@@@@@@@@@@@@@@@@@@@@@@@@@@@@@@@@@@@@@@@@@@@@@@@@@@@@@@@@@@@@@@@@@@@@@@@@@@@@@@@@@@@@@@@@@@@@@@@@@@@@@@@@@@@@@@@@@@@@@@@@@@@@@@@@@@@@@@@@@@@@@@@@@@@@@@@@@@@@@@@@@@@@@@@@@@
@                @                 @                                                                     @     @                                      @     @                                      @     @
@                @          T      @                                                                     @     @                                      @     @                                      @     @
@                @                 @                                                                     @  0  @                                      @  0  @                                      @     @
@                @    0            @                                                                     @     @                                      @     @                                      @     @
@                @                 @                                                                           @                                            @                        0                   @
@                @                 @                                                                           @              0                             @                                            @
@                @                 @                                                                           @                                            @                                            @
@                @                 @      @                                                                    @                                            @                                            @
@                @                 @   0  @                                                                    @                                            @                                            @
@                @                 @      @                                                                    @                                                                                         @
@                @                 @@@@@@@@@@@@@@@@@@@@@@@@@@@@@@@@@@                      @                   @@@                      @                                            @                   @
@                                                                                          @                   @                        @                           0                @                   @
@                                                                                          @                   @                        @                   @                        @                   @
@                                                                                          @                   @                        @                   @                        @                   @
@          0                                                                               @                   @                        @                   @                        @                   @
@                                                                                          @                   @                        @                   @                        @                   @
@                                                                   @                      @                   @                        @                   @                        @                   @
@                                                                   @                      @         @@@@@@@@@@@                        @         @@@@@@@@@@@            0           @         @@@@@@@@@@@
@                                                                   @                      @                   @              0         @                   @                        @                   @
@                                                                   @                      @               0   @                        @               0   @                        @               0   @
@                                           0                       @                      @                   @                        @                   @                        @                   @
@@@@@@@@@@@@@@@@@@@@@@@@@@@@@@@@@@@@@@@@@@@@@@@@@@@@@@@@@@@@@@@@@@@@@@@@@@@@@@@@@@@@@@@@@@@@@@@@@@@@@@@@@@@@@@@@@@@@@@@@@@@@@@@@@@@@@@@@@@@@@@@@@@@@@@@@@@@@@@@@@@@@@@@@@@@@@@@@@@@@@@@@@@@@@@@@@@@@@@@@@@
@                @                                                                         @                   @                                                                                         |
@                @                                                                         @                   @                                                                                         |
@                @                                                                         @                   @                                                                0                        |
@       0        @                                                                         @                   @                                            @                        @                   @
@                @                 @                             0                         @                   @                        @                   @                        @                   @
@                @                 @                                                       @                   @                        @                   @                        @                   @
@                @                 @                                                       @                   @                        @                   @                        @                   @
@                @                 @                                                       @                   @         0              @                   @                        @                   @
@                @                 @                                                   0   @                   @                        @                   @                        @                   @
@                @                 @                                                       @                   @                        @                   @                        @                   @
@                @                 @                                                       @                   @                        @                   @                        @                   @
@                @          0      @@@@@@@@@@@@@@@@@@@@@@@@@@@@@@@@@@@@@@@@@@@@@@@@@@@@@@@@@                   @@@@@@@@@@@@@@@@@@@@@@@@@@                   @@@@@@@@@@@@@@@@@@@@@@@@@@                   @
@                                  @                                                                  0        @                                   0        @                                   0        @
@                                  @                                                                           @                                            @                                            @
@                                  @                                                                           @                                            @                                            @
@                                  @                                                       @                   @                        @                   @                        @                   @
@                                  @                                                       @                   @                        @                   @                        @                   @
@                                  @                           0                           @                   @                        @                   @                        @                   @
@                                  @                                                       @                   @                        @                   @                        @                   @
@                                  @                                                       @                   @                        @                   @                        @                   @
@                                  @                                                       @                   @                        @                   @                        @                   @
@                                  @                                                       @                   @        0               @                   @                        @                   @
@                @                 @                                                       @                   @                        @                   @                        @                   @
@                @                 @                                                       @                   @                        @                   @           0            @                   @
@                @                 @                                                       @                   @                        @                   @                        @                   @
@                @@@@@@@@@@@@@@@@@@@                                                       @                   @                        @                   @                        @                   @
@                                                   @@@@@@@@@@      @@@@@@@@@@@@@@@@@@@@@@@@                   @@@@@@@@@@@@@@@@@@@@@@@@@@                   @@@@@@@@@@@@@@@@@@@@@@@@@@                   @
@                                                   @               @                                          @                                            @                                            @
@                                                   @               @                                          @                                            @                                            @
@                0                                  @     T         @              0                           @    T           0                           @               0                            @
@                                                   @               @                                          @                                            @                                            @
@@@@@@@@@@@@@@@@@@@@@@@@@@@@@@@@@@@@@@@@@@@@@@@@@@@@@@@@@@@@@@@@@@@@@@@@@@@@@@@@@@@@@@@@@@@@@@@@@@@@@@@@@@@@@@@@@@@@@@@@@@@@@@@@@@@@@@@@@@@@@@@@@@@@@@@@@@@@@@@@@@@@@@@@@@@@@@@@@@@@@@@@@@@@@@@@@@@@@@@@@@